"a" = (/turf/simulated/wall/wood,/area/outdoor)
"b" = (/turf/simulated/floor/plating/snow,/area/outdoor)

(1,1,1) = {"
aaaaaaaaaa
abbbbbbbba
abbabbabba
abaabbaaba
abbbbbbbba
abbbaabbba
ababbbbaba
abbaaaabba
abbbaabbba
aaaaaaaaaa
"}
